000R0000
00111000
31010110
1T111T10
11010130
00111000
00020000
00000000
16
