00000000
00000000
00211300
00000000
00211130
00000000
00000000
00000000
7
