00000000
00000000
00000000
00000300
00211110
00000000
00000000
00000000