21111111
00010100
00013100
00000000
00013100
00010100
21111111
00000000
15
