00000000
00000000
00000300
00000100
00221130
00000000
00000000
00000000
9