00000000
00000000
00311R00
00000000
00211130
00000000
00000000
00000000
7
