00000000
0000T120
00000000
021T0000
00000000
00211130
00000000
00000000
7
