00030000
00010000
000T0000
211011R0
01111100
001T1000
00113000
00000000
16
