00000000
02020300
01111100
00001100
03011100
01111100
00000000
00000000
20