00000000
00001T10
00001100
00003110
011T0000
02110000
01230000
00000000
12
